.............XXXXXXXXX.............
........XXXXX.........XXXXX........
.......X....X.........X....X.......
......X.....X...XXX...X.....X......
.....X...........X...........X.....
.....X.......................X.....
.....X....X......X......X....X.....
.....X....XXX....X....XXX....X.....
.....X....X.............X....X.....
......X.......XX...XX.......X......
......X.........X.X.........X......
.......X.........X.........X.......
..XXXXXXXX.......X.......XXXXXXXX..
.X>>>>>>>>.......X.......<<<<<<<<X.
X>..............X.X..............<X
X>.............X...X.............<X
X>.....X.....XXX...XXX.....X.....<X
X>.....X(((XX...X.X...XX)))X.....<X
X>.....X.........X.........X.....<X
X>.....X.........X.........X.....<X
.X.........X..r..X..b..X.........X.
..X..............X..............X..
...X.......X.....X.....X.......X...
....XXXXXXXXX...XXX...XXXXXXXXX....
.............XXX...XXX.............
